{
    "C3-JD-27_v2_1_1-split": {
        "0": "1",
        "1": "1",
        "2": "1",
        "3": "0",
        "4": "0",
        "5": "2",
        "6": "3",
        "7": "3",
        "8": "3",
        "9": "3",
        "10": "4",
        "11": "4",
        "12": "2"
    },
    "61-v2_1_1-split": {
        "0": "2",
        "1": "1",
        "2": "2",
        "3": "1",
        "4": "0",
        "5": "3",
        "6": "1",
        "7": "3",
        "8": "0",
        "9": "3",
        "10": "3"
    },
    "X11-SE1-v2_1_1-split": {
        "0": "0",
        "1": "3",
        "2": "0",
        "3": "0",
        "4": "2",
        "5": "2",
        "6": "1",
        "7": "1",
        "8": "1",
        "9": "4",
        "10": "4",
        "11": "4",
        "12": "4",
        "13": "3",
        "14": "3",
        "15": "3"
    }
}